064x064
(16.0, 23.0)(23.0, 24.0)
1111111111111111111111111111111111111111111111111111111111111111
1111111111111111111111111111111111111111111111111111111111111111
1111111111111111111111111111111111111111111111111111111111111111
1111111111111111111111111111111111111111111111111111111111111111
1111111111111111111111111111111111111111111111111111111111111111
1111111111111111111111111111111111111111111111111111111111111111
1111111111111111111111111111111111111111111111111111111111111111
1111111111111111111111111111111111111111111111111111111111111111
1111111111111111111111111111111111111111111111111111111111111111
1111111111111111111111111111111111111111111111111111111111111111
1111111111111111111111111111111111111111111111111111111111111111
1111111111111111111111111111111111111111111111111111111111111111
1111111111111111111111111111111111111111111111111111111111111111
1111111111111111111111111111111111111111111111111111111111111111
1111111111111111111110011111111111111111111111111111111111111111
1111111111111111111000111011111111111111111111111111111111111111
1111111111111111111011000110111111111111111111111111111111111111
1111111111111111101111000010011111111111111111111111111111111111
1111111111111100000100001010100111111111111111111111111111111111
1111111111111101100111000000111111111111111111111111111111111111
1111111111111101111000001010001111111111111111111111111111111111
1111111111111111010010001010010111111111111111111111111111111111
1111111111111111110000000000000010111011111111111111111111111111
1111111111111111111010000011101111101111011111111111111111111111
1111111111111110111100000001001110011011111111111111111111111111
1111111111111111111110100000000111111111100111111111111111111111
1111111111111111111010001010101101101111111111111111111111111111
1111111111111111111001000001110110111111111111111111111111111111
1111111111111111111100001100010001111101111111111111111111111111
1111111111111111101111110011110000111111111111111111111111111111
1111111111111111111101000001011011110111111111111111111111111111
1111111111111111111110000000000010010111111111111111111111111111
1111111111111111110110010111100100110101111111111111111111111111
1111111111111111111011010001110000001111111111111111111111111111
1111111111111111111111100011010010111111111111111111111111111111
1111111111111111111111100000001001111111111111111111111111111111
1111111111111111111110110100000001111111111111111111111111111111
1111111111111111111111010001000000011111111111111111111111111111
1111111111111111111111111110010010111111111111111111111111111111
1111111111111111111111111100000100011101111111111111111111111111
1111111111111111111111111011000111010001111111111111111111111111
1111111111111111111111111101100000101111111111111111111111111111
1111111111111111111111111110010000111111111111111111111111111111
1111111111111111111111111111100111111111111111111111111111111111
1111111111111111111111111111110111111111111111111111111111111111
1111111111111111111111111111111111111111111111111111111111111111
1111111111111111111111111111111111111111111111111111111111111111
1111111111111111111111111111111111111111111111111111111111111111
1111111111111111111111111111111111111111111111111111111111111111
1111111111111111111111111111111111111111111111111111111111111111
1111111111111111111111111111111111111111111111111111111111111111
1111111111111111111111111111111111111111111111111111111111111111
1111111111111111111111111111111111111111111111111111111111111111
1111111111111111111111111111111111111111111111111111111111111111
1111111111111111111111111111111111111111111111111111111111111111
1111111111111111111111111111111111111111111111111111111111111111
1111111111111111111111111111111111111111111111111111111111111111
1111111111111111111111111111111111111111111111111111111111111111
1111111111111111111111111111111111111111111111111111111111111111
1111111111111111111111111111111111111111111111111111111111111111
1111111111111111111111111111111111111111111111111111111111111111
1111111111111111111111111111111111111111111111111111111111111111
1111111111111111111111111111111111111111111111111111111111111111
1111111111111111111111111111111111111111111111111111111111111111
:0
:0
:0
:0
:0
:0
:0
:0
:0
:0
