064x064
(0.0, 10.0)(62.0, 10.0)
0000000001010000000000000000000000000000000000000000000000000000
0111111111011111111111111111111111111111111111111111111111111100
0100010000010000000001000001000000000000010000000000000100000100
0101010111110101111111010111010111111111010111111111110101110100
0101010000010100000100010100010100000001000100000000000100010100
0101111111010111110101110101110111011101111101111111111111010100
0101000000010000010000010100010001010000010001000000000100010100
0101011111110111111111010111011101011101110111110101110101110100
0101000001010100000001010001000101000101000100010101000101000100
0101111101010101111101110111110101010111011101010101011111010100
0100010001010100010001000100000101010000010001010101000000010100
0101110111010111010111011101111101011111110111010101111111110100
0100010100010001010001000100010101000100000100010100010100000100
0101010101011101011101110111010101110101011111011111010101111100
0101000101000101010000000100010101000101000001000000010001000100
0101111101110101011111011101110101011111111101111111110111110100
0101000000010001010001010001000101000000000001000000010100000100
0101111111111111010101110111010101111111111111011101110101111100
0100000001000000010100000001010101000100000001000101000100000100
0111111101011101110111111101110101010101110101110101011111010100
0100000101000101000100000100000101010101000100000101000001010100
0101111101010111011101110111110101110101010111111111111101110100
0101000101010000010001000100000101000101010100010000010001000100
0101010101111111110111011111111101011101010101010101110111011100
0100010100000000000100010001000001010001010101000101000100000100
0101110111111111111101110101011111010111010101111101011101110100
0100010001000000000100000101000101000101010101000001010001000100
0101110111010111110111111101010101011101011101011101011101010100
0101000100010100000100000001010100010001010001010001000101010100
0101011101110101111101111111010101111101010111011111110111010100
0101010001010100010001010000010100000001000101000100010000010100
0101010111010111010111010111110111111101111101110101011111110100
0101000100010001010100010100010001000001000001000101000001000100
0101111111011101010101010101111101011111111101011101010111011100
0100000000000101010101000001000001000000000001010001010100010100
0111111111110101110101111111011111111111111101010111011101110100
0100000000010100000100000100010000000001010001000101010001000100
0101110111010111111111111101110111111101010111111101010111010100
0100010100010000000000000101000100000101000000000101010100010100
0101110111111111111111110101011111011101011111110101010101111100
0101000100000001000000000100010001000101000100010101000100000100
0111011101110111011111111101110101110101011101010101111101110100
0100010001010100010000000000000100000101010001010100000001000100
0101110111010101110111111111111111111101110111010101111111010100
0101000100010100010100000000000000000101000101010100000001010100
0101011111010111011101111111111111110101011101010111111111011100
0100010000010001000001000000000101000100000001010000000001000100
0101110111111101111111011111110101011111111111011111111101110100
0100000100000001000000010000010101000000000001010001000001000100
0111110101111101011111010101110101111111111101010111011111010100
0100010100010001000001010100000001000000000100010001000000010100
0101110111011111111101011111111111010111110111110101111111110100
0101000101010000000101010000000100010100000100010100010000010100
0101011101010111110101010111110101110111110101011111010111010100
0101000101000100010001000100010101010000010001000100010001010100
0101110101111111011111111111010101011111011111110101111101010100
0100010100000000000000000001010001000100010001000001000001010100
0101110111011111111111111101011111110101110101111111011111010100
0101000100010100000001000101000000010101000100010000010001000100
0101011101110101111101010101111101010101011111010111111101111100
0100000001000000000100010000000001000100000001000000000000000100
0111111111011111111111111111111111111111111111111111111111111100
0000000001010000000000000000000000000000000000000000000000000000
0000000001010000000000000000000000000000000000000000000000000000
:0
:0
:0
:0
:0
:0
:0
:0
:0
:0
