064x064
(0.0, 1.0)(63.0, 63.0)
1111111111111111111111111111111111111111111111111111111111111111
0011100010001011011001101110111100011010000010001100011011111010
1100010001100101110111111001000110101101111100010001101110100100
0001101000101000101011111111100101000001101100001011110100001010
0110010110010001010010011010011011110101100011001111001011011101
1010101011111100010100001100110001101110010100110001111100101010
0100110111011100101001101010100111100011101000001011111110010110
0100001110100000100010100111100011010010010000010101100010000100
1001001001010000010101010100000001101000000000101010000100001000
0111100111111011000010111011101111010000001111110110111001100011
1110101001011001110011100101010011101110010100111001011110001010
0101010110000000001111110010100111001001100001110010010001011101
0010100000111100000111010001000110010000011011100100101000101010
0001111100110010011011100001101001011011000111011111000001010110
0011000000011100100101111001010011100100101010000110010100100001
0111101101000101000011100110100011011001010110000111110011001011
0010010010100110011110101001010100100000100000011101111100110110
1110101101110011000111001010101000010011011100111010000111001110
0100011000100100110110000100110011011100111011100001101111101101
0011100000000011001000011001000100111001010111000011111111011110
0111001101000101111111010011100111010110101000110111100110000110
0001110011101100111110110111100001001010010001110000101101011011
0100001010011100101111000010011110010010101110011101000010110000
0011110101111111011110110111001000100001010101010011000100111010
0111001100000110000100111010110101110011111010101111111010100000
0010110110001100111101101110001110011100101101000001001101010101
1011011110100111111100000101000101011010010110100110110110101010
0001101111000100111110110111111010110101000001101001001101001100
0111010001110010001011001100111111001001001111110110110111011011
0011001010111001100111100111001111100110101100010001101110110110
0110110101001100110011110011110111000001011101101011110100111110
1111001000111011100100101100011011111100110010110101100000111101
0111100000010111011001011111011001110101100100100000011001110011
0101111000100000100111100011000110111011110101010111100111001110
1010001100011111111010011110001001011100111111001011011000000100
0101100011111111111000100000110100100011011110100100111000110010
0110001000110010011101111110101000011000001000011001100101011000
1001011111011101100000110001010100110111110110000100000000111100
0110101000100010000110000101101110001100101001111101000001011101
0111100101011100001111001001010011011111010011100010011010111010
1001111100010001010110011111101011100111001100111001001101100101
0110010110100000101000010111010010011010001001010110010010110010
1100001101010010010000001010111101010000010110101000101100001100
0110000010001001100111010100010010111100100000010100111001010110
0110010100100000000011001100100111111101010011101111111110111011
0001100001111101000100011111011111001000101100110111010001010110
1110011010100011001010111110000110010100100010011100001111101100
0100100110000011100101000001110001100001001101101010001101010000
0111011010110011111010010110011000110010011010110111111110100010
0000110111000100001011101011001111011111011101001110011010011000
0111000001101110000101010100101001111010100110101000110001100100
0101101111011100010100010010010000100100011001011101010111011010
1110110100101000001010100001010001011001110101101000101011000101
0100110001100000010111011001101011110101101011000011011100001000
0111100011000100110011101100001111100100010100100001100011110010
0001011000100000000001111110011110011010101111100111010110001011
1110000111010001101011111101111001100101010011011001111110010110
0111111100110110010110011110110000011111001010001111111101100000
1000000000000000101100100011100110001001001100101000000011101110
0101100111101101101001000010000101000100110010010111000110011100
0110011001110011010111001100111011110111001101101000110000010000
1101110110101010101000111001000101001010001010010110001010101000
0111101111100101011111000100101100110100100100111001010100010110
0111010011000111100011100011000001101101010111100010110011000000
:0
:0
:0
:0
:0
:0
:0
:0
:0
:0
